000000000000000000000000000000000000
000000000000000000000000000000000030
000000000000000000000000000000000000
111111111111111111111111111111111111
111111111111111111111111111111111111
111111111111111111111111111111111111
111111111111111111111111111111111111
111111111111111111111111111111111111
111111111111111111000000000000001111
111111000000000000000000600000111111
111111111111111111100000000001111111
111111111111111111111111111111111111
111000111111111111111111111111111111
111020111111111100000000000000111111
111000111110000002000000000000111111
111111111111111100000000600000001111
111111111111111111111100000011111111
111111111111111111111111111111111111
111111111111111111111111111111111111
111111111111111111111111111111111111
111111111111111111111111111111111111
000000000000011111111111111111111111
020000060000011111111111111111111111
000000000011111111111111111111111111
111100000011111111111111111111111111
111111111111111111111111111111111111
111111111111111111111111111111111111
111111111111111111111111111111111111
111111111111111111111111111111111111
111111111111111111111111111111111111