000000000000000000000000000000000000
000000000000000000000000000000000030
000000000000000000000000000000000000
111111111111111111111111111111111111
111111111111111111111111111111111111
111111111111111111111000000011111111
111111111111111111111000400011111111
111111111111111111111000000011111111
111111111111111111111111111111111111
111111111111111111111111111111111111
111111111111111111111111111111111111
111111111111111111111111111111111111
111111100011111100011111111111111111
111111102011111102011111111111111111
111111100011111100011111111111111111
111111111111111111111111111111111111
111111111111111111111111111111111111
111111111111111111111111111111111111
111111111111111111111111111111111111
000000000011111111111111111000111111
110000400000111111111111111020111111
110000000000001111111111100000111111
111111110000000011111111111111111111
111111111111111111111111111111111111
111111111111111111111111111111111111
111111111111111111111111111111111111
111111111111111111111111111111111111
111111111111111111111111111111111111
111111111111111111111111111111111111
111111111111111111111111111111111111